111111111
11P100101
100010111
10C000001
101110111
1010000E1
111111111