111111111111111111
110100100000000001
100010111000000001
10C100000C00000001
1011101110000C0001
10100000100T000011
100000000000000001
11000000000000P011
1E00000000000000C1
111111111111111111