111111111111111111
11P100100000000001
100010111000000001
10C000000C00000001
1011101110000C0001
1010000010000000E1
100000000000000001
100000000000000001
100000000000000001
111111111111111111