111111111111111111
11010010T000000001
100010111000T00001
10C100000C00000001
1011101110000C0001
10100T00100000T011
100T00000000000001
1100000TTTTT00P011
1E00000000000000C1
111111111111111111