111111111111111111111111111111
10000000C10000100000000C010001
10000000010000T000000000010001
100000000T00001111110111110001
1110000001C000T00000000001T0C1
1CT000000T00001000000000010111
111110111111111000000000000001
100000000000TP0000000000000001
100000000000000000000000000001
100000000000000000000000000001
100000000000000000000000000001
10000000T111111111111T11111111
1000000000000111CTC1C01000T001
111000000101T00110111111101001
1C00000001C1010000000000T010E1
111111111111111111111111111111