111111111
10P000001
100000001
10C000001
100000001
100E00001
111111111