111111111111111111111
100000000000000000001
100000C0000C0000P0001
10000000000000000E001
111111111111111111111