111111111
10P000101
100000111
10C000001
101110001
101E10001
111111111