11111111111111111111111111111
10000000000000000011100000001
1000C0000C0000P00000100000001
10000000000000000010100000001
10000000000000000010110001101
100000000000000000100111010E1
10000000000000000011000001111
10000000000000000011000000001
10000000000000000011000000001
10000000000000000011000000001
10000000100000000011000000001
10000001110000000011000000001
10000000100000000011000000001
10000000000000000011000000001
10000000000000000011000000001
11111111111111111111111111111