11111111111111111111111111111
10000000000000000000000000001
10001000000P0P000000000000001
100C00000000000000000000E0001
10000000000000000000000000001
10000000000000000000001000001
11111111111111111111111111111