111111111
11P100101
100000111
10C000001
101110001
101E00001
111111111